##############
#    ####  #
  ###   ##  #
     ##  #
 #
#   ##     #
############