##############
#   #  ####  #
# ####  ##  ##
#   #  ##  # #
### # ##  # ##
#        ##  #
##############